22222222222222222222222222222222222222222222222222222222222222222222222222222222222222222222222222222222222222222222222222222222222222222222222222222222222222222222222222222222222222222222222222222222
2222229999999A99999999999999299999992299999999999962222AAAAAA66666666C62222266666666AAAAAAA6666666666669999A2A999999999999C99999999999A2222222229999999999999C99999AA99299999999999996666C6666A222222222
2666669992229999AA9999999A9929999999229999AA99999966222AA68886AAAAAA6C622222666666666AAAAA666CC66666CC69999A2A999999C999999999999C9999A2222222229992999999299C99999999929A222222929996666C6666A222222222
26666699922299999AA99999999929999CC92299999999999966622AAAAAA6A222226666222266AAA2666AAAAA666CC66666CC69999A2A9992222222222222222222A9AAAAA299299999999299999C99C99AA9929999999292222222222666A222222222
266666999999999999999999999929999CC92299A999999999666622222AA6AAAAA26666222266AAA2666AAAAA6666666666666AA99A2A9992299999999AAAAA2229A99999A299999299999999999C99999AA9929999999292A996C66C6666A222222222
26666699999999999AA99A99999999999999229999888899996666666A2AA66666A266666222C666626666AAA666666AAA22222AA99A229999999999999999AAAA22AAAAA9A29999999992999999929999999992EEEE9992C2A996C66C6666A222222222
26666699999999999AA999999999929999999299998888299926662A6A2AAAAAA6A2666662226666626666AAA6CC66AAAAA2222AA999A222999999222229999AAA222222A9A299999929999999222299999AA992EEE9999EC2A992222222222266666GG2
26666699992222999999999999999229999A9299998888299966622A6A22222AA6A266666622AA66626666AAA6666AAAAA22222AAA999A22222222222222999AAA22AAAAA9A299299999999C9A222299C99AA9929999999222A996662222222666666GG2
2666669999222299999999A999A9922999999999992222299966222A6A2AAAAAA6A2266666AAAA666266666A66666AAAA222222AAAA99A2222222222222999AAA222999999A299992999999C9A22229999999992999EEEE222A996266622222666622222
2666669999229999999999999999929999999999999999999962222A6A2A666666A22266C66A66662266666A6666AAAA2222222AAAAA999999999999999999A222999999AAA29999999999C992222299999AA992999EEEC222AA9666266CA66666622222
26666699992999999AA99999999992999222AA999999A9999922222A6AAA62222CA22226666A666222666666666622222222222AAAAACCC999999999999999A2222999222222222999999C99A2222299999AA99C9999EEE2222A96266626666666222222
26666699992999999AA999999A9992999222AA99999999999922222A66666CCCCCA222226666666222666666662222222222222AAAAACCC9999999999999999222229999999999999999C99A22222299C999999C9999EEC2222A9666266666A666222222
2222222222299999999999A999999299999992222EE999999922222AAAAAAAAAAAA222222666662222266666662222222222222AAAAACCC99999999999922222222222299999999999CC992222222299999AA99C99999992222222222266666662222222
22222222222222222222222222222222222222222222222222222222222222222222222222222222222222222222222222222222222222222222222222222222222222222222222222222222222222222222222222222222222222222222222222222222