00000000000000000000
00000000000000000000
00000000000000000000
000000000GG000000000
000000000GG000000000
00000000044000000000
00000000044000000000
00000000044000000000
000000000CC000000000
00000000044000000000
00000000044000000000
00000000444800000000
00000044444888000000
00004444444444440000
00088888444444444000
00888888888444444400
04444444444444444440
44444444444444444444
4444444AAAA4444CC444
444444444444444CC444
444CC444444444444444
444CC444444444444444
444444444444AAAA4444
4444AAAA444444444444
44444444444444444444
44444444444444444444
00004444400444440000
00000444400444444000
0000EEE444444EEE4444
0000EEE444444EEE4444
44444444444444444444
44444444444444444444
00000000044444444444
00000044444444444AAA
44444444444444444AAA
44444444888888444444
44444448888888844444
44444448484444444444
44444448884444444444
44444C444444C4444444
44444444444444444444
44444444444444444C44
44444444444444444444
44444444C44444444444
444C4444444444444444
44444444444444444444
44444444444444C44444
444C4444444444444444
44444444444444444444
44444444444444444444
88888888888888888888
8888888888888888AA88
8888A888888888888888
88888888888AA8888888
00000008888888888888
00000000008888800088
00000000888888800088
00008888888888800088
88888888888000000000
88888888000000000000
08888888888800000000
00000888888888880000
44444444444444444444
CCCCCCCCCCCCCCCCCCCC
AAAAAAAAAAAAAAAAAAAA
AAAAAAAAAAAAAAAAAAAA
AAAAAAAAAAAAAAAAAAAA
00000000044400000000
44444444444444444444
44444444444444444444
00000000004000000000
00000000004400000000
00000000000440000000
00000000000044000000
00000000000004000000
88888888888888888888
88888888C88888888888
88888888888888888888
8C888888888888888888
88888888000000000000
88888800000000000000
88888888888888888888
88888C8888C888888888
88888888888888888888
8888888888888C888888
88888888000008888888
888800000000888888C8
88888888888888888888
8888888888C888888888
88888888888888888888
88888C88888888888888
88888888888888888888
88888888888888888888
CCCCCCCCCCCCCCCCCCCC
44444444A44444444444
4444A444444444444A44
444444444444A4444444
44A444444A4444444444
44444A4444444444A444
4444444444A444444444
CCCCCCCCCCCCCCCCCCCC
44444444444444444444
44444444444444400044
44488888884444444444
48888844888884444444
44444444444444444444
4444444444444444444A
CCCCCCCCCCCCCCCCCCCC
44444444444444440044
44444444444444400444
44000444444000004440
44000000444440000444
44444000004444400044
44444444444444444444
CCCCCCCCCCCCCCCCCCCC
44444444444444444444
44444444444444444444
44488888844444444444
88888444444444444444
44400044444444444444
44400044444440004444
444444444A4444000444
44444444444444444444
44A44444444444444A44
444444444C4444444444
4444444444444C444444
C44444444A4444444C44
44444A44444444A44444
44444444444444444444
44444444444444444444
44444444444444000044
44444444444444000044
888884444AAA44444444
888844444AAA44444444
44444444444444444444
44444444444444444444
A44A44A44A44A44A44A0
44444444444444444440
44444444444444444440
44AA4440044448884AA4
44AA4444004444444AA4
44444444444444444444
44444AAAAAAAA4444444
44444AAAAAAAA4444444
44444444444444444444
44444444444444444444
00000000000000044444
4444444488C444444444
44448844884444444444
44448844444444444444
CC000000000000000000
88888888888888888888
88888888888888888888
88888888888888888888
000000000000000CCCC0
44444444444488844444
44448888444488844444
44448844444448844444
44444444444444444444
00000CCCC00000000000
44444444444444444444
44444444444444444444
44444444444444444444
44444444444444444444
00000000000000CCCC00
44444444444444444444
44444444444444444444
44444444444444444444
44444444444444444444
00000000CCCC00000000
44444444444444444444
44444444444444444444
44444444444404444444
44444884440444404440
44404444444444444044
44844440484844044444
44404484440484440484
48444044448444444844
44444444444404444444
00444444444444444888
44444400044444044888
44444400044444444444
44444444444488844444
44444444444488844444
44888888444444444444
44888888444444444444
44444444444444444040
44444444444444444040
00000444444488888444
00004448888888888444
44444448888888444444
44444448888888444444
44444444444444444444
44444444444444444444
00000000044400000000
00000000004444000000
00000000044444000000
00000000444440000000
00000004444440000000
00000044444400000000
00000044444400000000
00000044444440000000
00000444444444000000
00000444444444000000
44444444444444444444
44444444444444444444
44444444444444444444
44444444444444444444
44444444444444444444
00000000000000000000